







    ############################################
    #..  #......#...................###.......##
    #. .#####  .#########............##.     .##
    #...........##############     ..##.  ## .##
    ## .#####  .#######..............###  ## ..#
    #...#####  .#######...................## ..#
    #. #..     .##..                 . . ### ..#
    #...........##.     #######      . . ### ..#
    #.  ..     ###                    #.     ..#
    #.  ..#...........................#........#
    #.  ..#    .       #########################
    #.  ..#    .##     #################.......#
    #.  ..#    .##..............#..........###.#
    #.  ..#    .##        .     #      .   ###.#
    ##         .##     #  .           #....#...#
    #..............................######      #
    #.   ##    . .        .        ######    # #
    #.   ##    . .       #.               #    #
    #...........#........#.....................#
    ############################################